############A###############
#------#---#---------------#
#-######-#################-#
#------#-----------------#-#
######-########----------#-#
#------------------------#-#
#-#-#---------############-#
#-#-#----------------------#
#-#-###########--###########
#-#-----------#------------#
#-#########-#####---########
#---------#----------------#
##############B#############
