############A###############
#------#---#ooooooooooooooo#
#-######-#################o#
#------#-----------------#o#
######-########----------#o#
#------------------------#o#
#-#-#---------############o#
#-#-#-----------ooooooooooo#
#-#-###########-o###########
#-#-----------#-oo---------#
#-#########-#####o--########
#---------#---oooo---------#
##############B#############

Number of states explored (BFS): 74