############A###############
#------#---#ooooooooooooooo#
#-######-#################o#
#------#-----------------#o#
######-########----------#o#
#--ooo-------------------#o#
#-#o#o--------############o#
#-#o#oooooooooooooooooooooo#
#-#o###########--###########
#-#ooooooooo--#------------#
#-#########o#####---########
#---------#oooo------------#
##############B#############

Number of states explored (DFS): 174